2 5 3 6 2 4 4 3 2 4 3 6 7 5 
7 1 4 2 3 3 4 1 6 3 3 6 6 7 
2 6 6 1 4 6 4 3 2 1 3 3 2 5 
6 1 7 4 7 3 3 2 4 6 1 2 2 3 
5 5 2 4 3 7 5 6 4 6 6 5 4 1 
6 4 3 4 4 3 5 1 3 1 1 4 6 1 
5 5 1 3 2 2 6 5 6 1 1 2 5 7 
5 1 5 1 4 1 2 6 1 7 4 1 7 2 
